{
    "n15075141":{
        "0":[7],
        "1":[7],
        "2":[7],
        "3":[7],
        "4":[7]
    },
    "n13133613":{
        "0":[1],
        "1":[1],
        "2":[1],
        "3":[1],
        "4":[1]

    }
   
}